39
True
30
...X....X...X.@X.
..X..X.....X..X..
.X....X...X.X....
.....X...X.X.....
..X....XX....X..X
....XXX.....X...X
.XXX.X..X......X.
....X.XX...XX.X..
.X.X....XX...X...
.X.X.X....X.X....
.....XX...X...X..
.X.....X...XX..X.
..X..X..X.X......
p..X..X.......X..